111111111111111111111111111111
100010010000000000100031011001
101110000301300000011003000011
100000010000100011030001000001
101100000100000000101001001001
111010000000001000000000110001
100000000011000003000311110011
130100010100100000111000001001
110000001100010000000010001001
100000100011111000000003000001
101100031001001000000100003001
100000000000000100000001000001
101011000001100000001100001111
101010000011000010310300010001
110110100001103030000100010001
101101000000003010001000300301
101100010110103130100000000001
110000103000301030003000100001
100000100001113100000000100001
100000000000001100001001011101
131300010103010101000100003001
100100000000000013001010000301
100301100000103110110000000001
101000000000000000010010000031
101000000100100010000000000131
100113100110000101000001000001
100100100000300103300030113001
100130101101000101301010000001
111000003000000000000000100001
111111111111111111111111111111