3000010000000000110000003
0000010000000110001100000
1031310000100300000000010
0030003000100010001000100
0000331100001330001300001
0001000101000000003010010
1000010310000001003000001
3110000300101000010011110
0000001010300001101010100
0000000010001000000000001