100000310000000000010101300100
001010000031303001100010001030
000030000000003001000000000000
000000103000003010010310010013
030030100000030101000000000001
030001111000001000000001000000
000001030000001100000000000000
000010013100100001000111010011
100000300110100010000110100001
011030100000000010001010100001
001001100100113000000000100111
100010010000000000001001000300
000001000101000100100000001100
011003300310001000100000010010
011001100000310100000000000001
000000000000000303110000101000
000000001011000100000000100110
000010111000000010000000000000
000130000110100101310001001301
000000000100000010010000001003
011000000100111010000000010101
301000100031011300000000001101
000110000010100010000100001000
001100010100100101001030000001
000000000000000000000000000000
000000000000001000101000010110
003010000000130000010300000100
100110100010000003000000000010
003100000010303000101000001010
010001011101130000000000101000