111111111111111111111111111111
100100000201000000100200000011
100100000000000011000010100001
100001000000001001110020101101
100000000201011000000000000001
100000000110000001000001200101
100000010100000011100021000001
110001101000001000000100000001
100200000000120000112000001001
100000020210000020001010011101
100000001010000220200001010011
100001010000010000100000002001
100000020000100001010020000001
100002110000000000010001010001
101100000002011001000201001001
100022100000010010100100011011
101100000010000000010200001001
100000000010000102000100010001
100020100100010011020010010011
100000012100001000000111020001
100100010000010200100000000101
120001000020000000001001100101
100120201001001000100000100001
101100210110000002200100100021
100101000010000000000100010211
102000002000010010010000000001
100101010100000010000002010001
100011000200000000010000000001
100110010100100010000111010001
111111111111111111111111111111