111111111111111111111111111111
101000310101001000110000010011
110000310001000003000110100001
101000010300101000100000000111
100001000000000000000001000001
100000010310100100000000000011
100100110101010000000100003001
103011000101000010030000010011
101000100001000000100103010001
100100010100000000300101000011
101000100100010100000000000001
101001000100000101000010113301
100000003101000010030311011001
100100000000000103000300003001
100013001000010000000000001011
100111000010300300010100110031
110000030000000000000000001001
130000001031000000010100000101
110133000000001011001010010111
110000000110301000000010001011
131001001000000000100000000001
100000000011001000000000000101
100000310000300001001010100101
110010000100001000011000000001
110000000001010300000100001001
100000000000101000310310100001
100000000001000300000001000001
100000000000000100010011000001
100100000000000101001000001001
111111111111111111111111111111