001000000010011000000110000010
030000000000001000300000000000
110000001000033000101000100001
110000010000000001300000000110
010000000001101030000100000000
000011000000001001001000010000
000000300000000000300001010101
000000000011000000010001010000
000100000000100300001000010310
030000010001011000000003001000
000001010100010001101003000013
000300000001001030000013000110
011110001100000000001000000100
000000001000100000001100100101
101110000000003100010001030001
011101301030000010030000000010
000001010000010000100103100001
100100330000300001030101000010
000010013000100000100031010000
000301000000000300101011000111
010000031100000110000010000100
101003030100000000000000010000
010000010110000031010100000000
100001000010300130100000000000
010000000000010000300103000001
000000010000000011100030100000
000000000000101010000100000001
000000010000000001100030000110
000100100010000030000000100000
100100000300110000101100010100