111111111111111111111111111111
110001000000001000100000020001
100011001111002200001011002021
120000000010000000211000000011
100100000000000001000001011011
100100001100000001100202100001
111000001020100010000000100001
101010000000000021001010000001
100000000002001000000001010101
100000000101000000100001101011
100001010100100010002001000001
100101000000001000002000010101
100011000000120010110011100001
100000002200101010002001000101
101010000100000000011000000101
110110001001000000011000000001
100101000000000000100000010001
100000000000000002100000000101
100001000000000100100100220001
100000100001001001000000010001
111001010010012000002021001001
100102120000101110000011220001
111100000000000001101000200001
100001001001000221000010000021
101101000010100001110000000011
100000000000000002000010000001
110000210000100120001000000001
102000000010000010000101100011
100001000000202100000000000001
111111111111111111111111111111