111111111111111111111111111111
111001000000000002100200100001
100000020001000010000000101001
100010120000000010000011010011
102000001000000000200000100001
101000000000001100000000000101
100001000010101001011000020001
110000101211002001001010010101
110000000000011000000100101021
110000000110010000201101110001
101000010110102000000001000001
100021101010000000100100000221
100200100000102001200001010001
100010120011001100120010000021
100000002000100010001000201011
100001000200000000000000100001
110000000000000000000002010001
100000100000000000200001120001
100001000011200200100010202001
100001000000020012100000000001
110100000111001001000001200011
101000100111100000000000010101
100010000000100200100000022001
101002001000100100200220001001
100102000200000001101100020001
100000101010000000010020101101
100000012000000100100000102001
100000000000000000020100000101
100002010010010010000212001001
111111111111111111111111111111